5,0,0,0,0,1,0,0,3,5,0,0,0,0,0,0,0,1,0,1
3,0,0,0,0,0,0,0,2,3,0,1,0,0,0,0,3,5,1,1
1,1,0,0,0,0,0,1,1,1,1,1,0,0,0,2,2,0,4,0
0,4,5,0,0,0,0,0,0,0,0,0,0,0,1,1,1,1,1,1
1,1,1,1,0,0,0,0,1,1,1,0,0,0,1,0,1,0,0,1
1,0,0,0,0,0,0,0,0,5,0,0,0,0,5,0,2,2,2,0
0,2,0,5,0,0,0,0,1,0,1,0,0,0,0,0,1,0,0,1
1,1,1,1,0,1,1,0,0,0,0,0,0,0,1,1,1,1,1,1
0,1,0,0,0,0,0,0,0,0,5,0,0,0,0,1,1,1,1,1
0,6,0,5,0,0,0,0,0,0,2,2,0,0,0,0,1,1,1,1