0,0,4,0,0,0,0,0,0,0,0,0,0,0,0,0,0,0,0,1
0,0,2,0,0,0,0,0,0,0,0,0,0,0,0,0,0,0,0,0
0,1,1,1,1,0,0,0,0,0,0,0,0,0,0,0,0,0,1,0
0,0,0,1,0,0,0,0,4,0,2,2,4,0,0,0,0,0,4,0
0,0,0,0,0,0,0,1,1,1,1,0,0,0,1,0,0,2,0,0
0,0,0,1,0,0,0,0,0,0,0,0,0,0,0,0,1,1,1,1
0,0,4,0,0,0,0,0,0,3,2,4,0,0,0,0,0,0,0,0
0,1,2,2,1,0,0,0,1,1,1,1,1,0,0,0,0,0,0,0
0,1,1,1,1,0,0,0,0,0,0,0,0,0,0,0,4,0,4,0
0,0,0,0,0,0,0,0,0,0,0,0,0,1,1,1,0,1,0,1